60 13

************************************************************
*..........................................................*
*.....*..........................................*.........*
*..........................................................*
*..........................................................*
*.......................................*..................*
*..........*...............................................*
*.................................................*........*
*..........................................................*
*.................*........................................*
*.......................................*..................*
*..........................................................*
************************************************************