60 13

************************************************************
*..........................................................*
*......*.....................*......................*......*
*..........................................................*
*......*............................................*......*
*..........................................................*
*......*........*..........................*........*......*
*..........................................................*
*......*............................................*......*
*..........................................................*
*......*.....................*......................*......*
*..........................................................*
************************************************************