60 13

************************************************************
*...........................*..............................*
*...........................*..............................*
*...........................*..............................*
*..........................................................*
*..........................................................*
*******..............................................*******
*..........................................................*
*..........................................................*
*...........................*..............................*
*...........................*..............................*
*...........................*..............................*
************************************************************